2 3 3 3 3 3 3 3 3 3 3 3 3 3 3 4
5 0 1 0 1 0 1 0 1 0 1 0 1 0 1 9
5 1 10 1 10 1 10 1 10 1 10 1 10 1 10 9
5 0 1 0 1 0 1 0 1 0 1 0 1 0 1 9
5 1 10 1 10 1 10 1 10 1 10 1 10 1 10 9
5 0 1 0 1 0 1 0 1 0 1 0 1 0 1 9
5 1 10 1 10 1 10 1 10 1 10 1 10 1 10 9
5 0 1 0 1 0 1 0 1 0 1 0 1 0 1 9
5 1 10 1 10 1 10 1 10 1 10 1 10 1 10 9
5 0 1 0 1 0 1 0 1 0 1 0 1 0 1 9
5 1 10 1 10 1 10 1 10 1 10 1 10 1 10 9
6 7 7 7 7 7 7 7 7 7 7 7 7 7 7 8
